WWWWWWWWWW
W--------W
WFF--W---W
W---FW--FW
WWWWW---FW
W---W---WW
W-F-B--F-W
W-WWWF---W
W-WFF--F-W
WWWWWWWWWW
(3,3)
(7,1)
(7,2)
(7,7)
(5,8)
(1,5)
